22,12
GGGGGGGGGGGGGGGGGGGGGG
GPPPPSSSSSPGGGGGPGGGGG
GGGGPPGGGGPPPPSSPPPPPG
GGGGPGGGGGSGGGGGPGGGPG
GPPPPPPPPSSSPPPPPPPPPG
GSGGPGPGGPSGPGGGGGSGPG
GSPPPPPGGGPGPPSSSSSGPG
GPGPGGSSSSPGGGSGGSGGPG
GPGPGGPGSGPPSSSPPSSSPG
GPGPGPPGSGPGGGPGGGGPGG
GPSSSPGGSPPGGGPPPPPPGG
GGGGGGGGGGGGGGGGGGGGGG