22,12
GGGGGGGGGGGGGGGGGGGGGG
GGGPPSSSSSSSSSPGGGGGGG
GGPPPPPGGGPPGGPPPGGGGG
GGPGGPGGGGPPGGPGGGGGGG
GGGPPSSSSSPGGGPPPPPPGG
GPPPPPPPGSGGGGPGGGGPGG
GGGSSGGGGSSSPPPPPPPPSG
GPPPPPPGGSGSGGPGGGGGSG
GPGGGGPGGSGSGGPPPPPGSG
GPPPPPPSSSSSSSPGGGGGPG
GPGGGGPGGGGGGGPPPPPPPG
GGGGGGGGGGGGGGGGGGGGGG