22,12
GGGGGGGGGGGGGGGGGGGGGG
GGGGGGGGGGGGGGGGGGGGGG
GPPPPPSSSSSSSSPPPPPPGG
GPGGGPGGGGGGGGPGGGGPGG
GPGGGPPPPPPPPPPGGGGPGG
GPPPGPGGGGGPGGPGGGGPGG
GPGPGPGGGGGPGGPGGGGPGG
GPPPPPPPPPPPPPPPPPPPGG
GGPGGGPGGGGGGGGPGPGPGG
GGPPPPPPPGGGPPPPPPPPGG
GGPPPPPPPPPPPGGGGGGGGG
GGGGGGGGGGGGGGGGGGGGGG
