22,12
GGGGGGGGGGGGGGGGGGGGGG
GGGGPPPPPPGGGPPPPPPPGG
GGGGSGGGGPGGGPGGGPGPGG
GGGGSSSSSPPPPPPGGPPPGG
GGGGSGGGGPGGGGPGGGGGGG
GPPPPPPPPPGGGGPSPPPPPG
GGGGPGGGGPGGGPGGGGPGGG
GPPPPPPPSPGGGPPPPPPGGG
GPGGGGGPGPPPPPGGGGSGGG
GPGGPPGPGGGGPGGGGGSPPG
GPPPPPPPGGGGPGGGGGGPGG
GGGGGGGGGGGGGGGGGGGGGG