22,12
GGGGGGGGGGGGGGGGGGGGGG
GPPPPPPPGGGGPGGGGGGPGG
GPGGPPGPGGGGPGGGGGSPPG
GPGGGGGPGPPPPPGGGGSGGG
GPPPPPPPSPGSGPPPPPPGGG
GPGGPGGGGPGSGPGGGGPGGG
GPPPPPPPPPSSSPPPPPPPGG
GPGGSGGGGPGSGGPGGGGPGG
GPGGSSSSSPPPPPPGGPPPGG
GPGGSGGGGPGGGPGGGPGPGG
GPPPPPPPPPGGGPPPPPPPGG
GGGGGGGGGGGGGGGGGGGGGG